27
20
0 0 0 0 0 0 0 0 0 0 0 0 0 0 0 0 0 0 0 0 0 0 0 0 0 0 0
0 0 0 0 0 0 0 0 0 0 0 0 0 0 0 0 0 0 0 0 0 0 0 0 0 0 0
17 9 18 18 0 0 0 18 18 18 18 18 18 18 18 18 18 18 18 18 0 0 0 18 18 17 17
17 15 0 0 0 0 0 0 0 0 0 0 0 0 0 0 0 0 0 0 0 0 0 0 0 17 17
17 15 0 0 0 0 0 0 0 0 0 0 0 0 0 0 0 0 0 0 0 0 0 0 0 17 17
17 15 0 0 0 0 0 0 0 0 0 0 0 0 0 0 0 0 0 0 0 0 0 0 0 17 17
17 15 0 0 0 0 0 0 0 e 0 0 0 0 0 0 0 0 0 0 0 0 0 e 0 17 17
17 16 11 11 13 0 0 12 11 11 0 0 0 11 11 11 11 11 11 13 0 0 0 12 11 17 17
17 15 0 0 0 0 0 0 0 0 0 0 0 0 0 0 0 0 0 0 0 0 0 0 0 17 17
17 15 0 0 0 0 0 0 0 0 0 0 0 0 0 0 0 0 0 0 0 0 0 0 0 17 17
17 15 0 0 0 0 0 0 0 0 e 0 0 0 e 0 0 0 0 0 0 0 0 0 0 17 17
17 15 0 0 12 11 11 11 11 11 11 11 11 11 0 0 0 11 11 13 0 0 0 12 11 17 17
17 15 0 0 0 0 0 0 0 0 0 0 0 0 0 0 0 0 0 0 0 0 0 0 0 17 17
17 15 0 0 0 0 0 0 0 0 0 0 0 0 0 0 0 0 0 0 0 0 0 0 0 17 17
17 15 e 0 0 0 0 0 0 0 e 0 0 0 0 0 0 e 0 0 0 0 0 e 0 17 17
17 16 11 11 13 0 0 12 11 11 11 11 11 11 11 11 11 11 11 13 0 0 0 12 11 17 17
17 15 0 0 0 0 0 0 0 0 0 0 0 0 0 0 0 0 0 0 0 0 0 0 0 17 17
17 15 0 0 0 0 0 0 0 0 0 0 0 0 0 0 0 0 0 0 0 0 0 0 0 17 17
17 15 0 0 0 0 0 0 0 0 0 0 0 0 0 0 0 0 0 0 0 0 0 0 0 17 17
17 17 17 17 0 0 0 17 17 17 17 17 17 17 17 17 17 17 17 17 0 0 0 17 17 17 17